#####O###
#       #
# ## ## #
# #   # #
# # # # #
# # # # #
# # # ###
#       #
#######X#