#####O#
#   # #
# # # #
# #   #
# ### #
#   # #
#####X#